time,TOTAL,"TOTAL
Residents","TOTAL
Residents
FED","TOTAL
Residents
Intragovernmental holdings","TOTAL
Residents
Depository institution","TOTAL
Residents
Pension funds","TOTAL
Residents
Pension funds
Private","TOTAL
Residents
Pension funds
State  and  local  governments","TOTAL
Residents
Insurance companies","TOTAL
Residents
Mutual  funds","TOTAL
Residents
State  and  local  governments","TOTAL
Residents
U.S.  savings  bonds","TOTAL
Residents
Other  investors","TOTAL
Foreign  and  international"
2002_4,6405700,5170100,666665,2720535,222600,312700,153800,158900,139700,281000,354700,194900,277400,1235600
2003_1,6460800,5185600,640891,2749909,153600,327900,165800,162100,139500,296600,350000,196900,330200,1275200
2003_2,6670100,5298200,651993,2853407,145400,331500,170200,161300,138700,302300,347900,199200,327800,1371900
2003_3,6783200,5339900,655993,2859307,146800,323200,167700,155500,137400,287100,357700,201600,371000,1443300
2003_4,6998000,5474900,666665,2953435,153100,320800,172200,148600,136500,280900,364200,203900,395400,1523100
2004_1,7131100,5461100,674084,2954216,162800,313400,169800,143600,172400,280800,374100,204500,324800,1670000
2004_2,7274300,5538900,687391,3055409,158600,308200,173300,134900,174600,258700,381200,204600,310100,1735400
2004_3,7379100,5584600,698617,3073383,138500,314800,174000,140800,182900,255000,381700,204200,335500,1794500
2004_4,7596100,5746800,717813,3187787,125000,324700,173700,151000,188500,254100,389100,204500,355400,1849300
2005_1,7776900,5824700,717536,3204064,141800,335300,177300,158000,193300,261100,412000,204200,355500,1952200
2005_2,7836500,5959000,726022,3307478,126900,352300,181000,171300,195000,248700,444000,204200,354400,1877500
2005_3,7932700,6003100,736082,3331718,125300,349000,184200,164800,200700,244700,463700,203600,348200,1929600
2005_4,8170400,6136500,744210,3455590,117100,338700,184900,153800,202300,251300,475000,205200,347000,2033900
2006_1,8371200,6289100,758529,3498671,113000,269700,116800,152900,200300,254200,515700,206000,473000,2082100
2006_2,8420000,6442200,766349,3622851,119500,267300,117700,149600,196100,243400,531600,205200,490100,1977800
2006_3,8507000,6481700,768915,3663885,113600,275100,125800,149300,196800,234200,542300,203700,483200,2025300
2006_4,8680200,6577100,778938,3779162,114800,293200,139800,153400,197900,248200,570500,202400,392000,2103100
2007_1,8849700,6654900,780890,3795710,119800,296000,139700,156300,185400,263200,608300,200300,405200,2194800
2007_2,8867700,6675700,790497,3924603,110400,302200,139900,162300,168900,257600,637800,198600,285100,2192000
2007_3,9007700,6772400,779633,3958367,119700,293700,140500,153200,155100,292700,643100,197100,332900,2235300
2007_4,9229200,6876000,754612,4078888,129800,285200,141000,144200,141900,343500,647800,196500,297800,2353200
2008_1,9437600,6931300,612305,4082395,125000,279100,143700,135400,152100,466700,646400,195400,371900,2506300
2008_2,9492000,6904600,478796,4207004,112700,280500,145000,135500,159400,440300,635100,195000,395900,2587400
2008_3,10024700,7222300,476578,4216122,130000,283700,147000,136700,163400,631400,614000,194300,512900,2802400
2008_4,10699800,7622600,475921,4330479,105000,277300,147400,129900,171400,758200,601400,194100,708900,3077200
2009_1,11126900,7861200,474746,4310454,125700,292400,155400,137000,191000,721100,588200,194000,963700,3265700
2009_2,11545300,8084500,653193,4373607,140800,308700,164100,144600,200000,711800,588500,193600,914200,3460800
2009_3,11909800,8339200,769160,4357940,198200,312800,167200,145600,210200,668500,583600,192500,1046300,3570600
2009_4,12311300,8626200,776587,4500313,202500,327000,175600,151400,222000,668800,585600,191300,1152100,3685100
2010_1,12773100,8895200,776705,4483095,269300,336600,183000,153600,225700,678500,585000,190200,1350100,3877900
2010_2,13201800,9131800,776989,4568111,266100,340900,190800,150100,231800,676800,584400,189600,1497100,4070000
2010_3,13561600,9237400,811669,4538831,322800,343400,198200,145200,240600,671000,586000,188700,1534400,4324200
2010_4,14025200,9589600,1016102,4640098,319300,360500,206800,153700,248400,721700,595700,187900,1499900,4435600
2011_1,14270000,9788600,1333445,4625455,321000,373700,215800,157900,253500,749400,585300,186700,1360100,4481400
2011_2,14343100,9652500,1617060,4603340,279400,409800,251800,158000,254800,753700,572200,186000,976100,4690600
2011_3,14790300,9878200,1664655,4663345,293800,529300,373600,155700,259600,788700,557900,185100,935800,4912100
2011_4,15222800,10215900,1672092,4767508,279700,552600,391900,160700,297300,927900,562200,185200,971400,5006900
2012_1,15582300,10437200,1664911,4732289,317000,576000,406600,169400,298100,1015400,567400,184800,1081200,5145100
2012_2,15855500,10544600,1666530,4809270,303200,598600,427400,171200,293600,997800,585400,184700,1105400,5310900
2012_3,16066200,10590100,1648403,4798397,338200,635600,453900,181700,292600,1080700,596900,183800,1015400,5476100
2012_4,16432700,10858900,1656930,4866770,347700,651600,468000,183600,292700,1031800,599600,182500,1229400,5573800
2013_1,16771600,11046600,1794459,4862341,338900,656800,463400,193400,284300,1066700,615600,181700,1245700,5725000
2013_2,16738200,11143200,1928416,4844884,300200,632200,444500,187700,276200,1000100,612600,180900,1367800,5595000
2013_3,16738200,11085400,2062004,4772196,293200,535300,347800,187500,273200,986100,624300,180000,1359100,5652800
2013_4,17352000,11559400,2208829,4996471,321100,646200,464900,181300,271200,983300,633600,179200,1319500,5792600
2014_1,17601200,11652900,2311539,4989961,368400,658600,474300,184300,276800,1060400,632000,178300,1177000,5948300
2014_2,17632600,11613900,2396972,5064028,409500,680900,482600,198300,287700,986200,638800,177600,972100,6018700
2014_3,17824100,11754900,2448625,5042175,471100,689400,490700,198700,298100,1075800,628700,176700,924100,6069200
2014_4,18141400,11983700,2461364,5117536,516800,706300,507100,199200,307000,1121800,654500,175900,922400,6157700
2015_1,18152100,11979500,2459666,5061634,518100,624500,447800,176700,305100,1170400,674200,174900,990900,6172600
2015_2,18152000,11988900,2460911,5075589,518500,559500,373800,185700,304300,1139800,655000,173900,1101300,6163100
2015_3,18150600,12044700,2461948,5026752,519100,476300,305300,171000,306600,1195100,646400,172800,1239700,6105900
2015_4,18922200,12776000,2461554,5249646,547400,679200,504700,174500,306700,1318300,680400,171600,1361100,6146200
2016_1,19264900,12980500,2461326,5340074,562900,694800,524400,170400,315500,1404100,692600,170300,1339000,6284400
2016_2,19381600,13102500,2462303,5448897,580600,722900,537900,185000,329800,1434200,710000,169000,1244800,6279100
2016_3,19573400,13417500,2463460,5400040,627600,749400,545600,203800,341200,1600400,734000,167500,1333900,6155900
2016_4,19976900,13970600,2463601,5541999,663900,756800,538000,218800,330200,1705400,744200,165800,1598800,6006300
2017_1,19846400,13771100,2464335,5476765,658600,683700,444200,239500,338400,1669100,751100,164200,1564900,6075300
2017_2,19844600,13692700,2465046,5478354,621900,688700,425900,262800,348400,1608500,736400,162800,1582500,6151900
2017_3,20244900,13943000,2465427,5571473,611800,837300,570800,266500,359700,1697800,716000,161700,1521900,6301900
2017_4,20492700,14281400,2454219,5677881,638300,721400,432000,289400,372600,1797500,732300,160400,1726900,6211300
2018_1,21089900,14866500,2424883,5661717,639700,897800,597700,300100,361800,1977100,712900,159000,2031600,6223400
2018_2,21195300,14970300,2378250,5728650,665300,929800,622500,307300,225900,1843400,727300,157800,2314000,6225000
2018_3,21516100,15290200,2313208,5754892,683900,948700,644000,304700,226100,1898200,722200,156800,2586300,6225900
2018_4,21974100,15703000,2240717,5854283,771500,1043700,670900,372800,203700,2023300,693000,155700,2717000,6271100
2019_1,22028000,15553100,2175596,5823504,771300,883300,478200,405100,201100,2058300,691800,154500,2793600,6474900
2019_2,22023500,15383000,2110256,5834944,810000,920700,506000,414700,202100,1929900,674500,153400,2747300,6640500
2019_3,22719400,15940300,2107683,5915917,909900,1152000,727500,424500,208200,2173500,676700,152300,2644100,6779100