time,TOTAL,"TOTAL
Domestic resident","TOTAL
Domestic resident
Private non-financial corporations","TOTAL
Domestic resident
MFI","TOTAL
Domestic resident
MFI
Central Bank","TOTAL
Domestic resident
MFI
OMFIs","TOTAL
Domestic resident
Other financial intermediaries and auxiliaries","TOTAL
Domestic resident
Insurance and pension funds","TOTAL
Domestic resident
Public Corporations","TOTAL
Domestic resident
Local government","TOTAL
Domestic resident
HHs and NPISHs","TOTAL
Domestic resident
Other resident","TOTAL
Rest of the World"
1998_2,330894,264384,1588,18805,1557,17248,10214,221120,3169,785,6255,2448,66510
1998_3,349657,279351,902,22165,1554,20611,13847,228873,3251,801,6095,3417,70306
1998_4,359271,285342,883,17234,1556,15678,16688,235662,3358,813,6094,4610,73929
1999_1,344222,273132,381,11629,1400,10229,12209,234477,3404,686,6376,3970,71090
1999_2,340383,271669,225,10490,1365,9125,9882,236485,3668,670,5888,4361,68714
1999_3,327585,267161,86,10664,1377,9287,11368,230384,3804,675,5959,4221,60424
1999_4,333981,273056,66,11748,1465,10283,6107,241080,3725,672,5572,4086,60925
2000_1,328934,267700,96,9507,1524,7983,7095,237470,3739,637,6130,3026,61234
2000_2,334835,276360,182,10177,1582,8595,14782,237938,3701,685,5765,3130,58475
2000_3,332795,273308,394,10189,1625,8564,21867,227836,3567,728,5623,3104,59487
2000_4,329197,266816,478,5457,1630,3827,24703,223848,3545,467,5145,3173,62381
2001_1,319011,261668,659,7958,1637,6321,27351,216381,3443,390,4418,1068,57343
2001_2,311321,250675,699,9365,1910,7455,17433,213120,3649,431,4971,1007,60646
2001_3,312539,252315,681,10787,1922,8865,21525,209769,3267,506,5281,499,60224
2001_4,300511,240648,312,3361,1923,1438,9758,218346,3131,660,4760,320,59863
2002_1,298663,243364,268,6510,1924,4586,10984,216743,2650,844,5220,145,55299
2002_2,300438,244706,388,2527,1880,647,8920,223246,2971,622,5828,204,55732
2002_3,309815,253676,398,345,1814,-1469,11878,231603,3001,461,5896,94,56139
2002_4,311141,254754,458,-1143,1634,-2777,11752,234299,3220,375,5684,109,56387
2003_1,320505,263057,405,2642,1821,821,15004,236204,3187,431,5641,-457,57448
2003_2,324715,264141,333,561,1756,-1195,13019,241508,3157,616,5407,-460,60574
2003_3,333425,271642,335,750,1795,-1045,18023,244178,3177,504,5122,-447,61783
2003_4,333164,267052,318,-5781,1786,-7567,11614,252624,3228,272,5334,-557,66112
2004_1,345235,275861,297,-7523,1867,-9390,13624,261238,3165,204,5520,-664,69374
2004_2,351687,274181,349,-5692,1902,-7594,8743,262246,3176,227,5079,53,77506
2004_3,369321,286883,324,-4068,1949,-6017,16940,264128,3304,190,5498,567,82438
2004_4,383548,294204,353,-1043,1810,-2853,15830,268212,3301,175,6336,1040,89344
2005_1,392771,298331,237,-4292,1869,-6161,23213,267955,3277,215,6483,1243,94440
2005_2,415430,314789,265,-1599,1840,-3439,34936,270441,2792,179,6658,1117,100641
2005_3,429364,316449,231,-1309,1930,-3239,33955,271066,2807,195,7395,2109,112915
2005_4,440343,320856,233,-2527,2135,-4662,29743,280873,2468,180,7576,2310,119487
2006_1,446329,323011,200,-4108,2225,-6333,35531,280043,698,525,7552,2570,123318
2006_2,453733,329238,233,-46,2294,-2340,43923,275581,567,318,5986,2676,124495
2006_3,468639,333251,212,-2629,2379,-5008,38285,288127,496,149,5516,3095,135388
2006_4,469036,323839,233,-7572,2337,-9909,30669,290457,496,249,5902,3405,145197
2007_1,464014,321338,159,-16337,2398,-18735,34788,292091,496,146,6726,3269,142676
2007_2,467104,311310,317,-9829,2396,-12225,30307,279915,496,168,6343,3593,155794
2007_3,490376,330175,554,-8023,2399,-10422,39688,287908,496,191,5253,4108,160201
2007_4,513511,342392,603,-5459,2423,-7882,43280,292900,713,124,6109,4122,171119
2008_1,520164,347204,370,-3139,3300,-6439,46163,293392,713,147,5209,4349,172960
2008_2,527277,346291,734,-3046,4659,-7705,60754,276340,822,222,5717,4748,180986
2008_3,556983,353121,812,2683,6064,-3381,57879,278068,822,179,7347,5331,203862
2008_4,645307,427371,859,24348,7116,17232,99343,288470,1200,168,6522,6461,217936
2009_1,666916,438441,382,55383,23490,31893,92374,278840,1300,182,5003,4977,228475
2009_2,712978,493461,657,132448,106683,25765,67258,281071,1300,165,5350,5212,219517
2009_3,794504,565614,972,195466,164466,31000,51796,301700,1300,162,6126,8092,228890
2009_4,822022,586493,1329,226185,190269,35916,44644,297424,1300,197,7048,8366,235529
2010_1,875128,617872,1420,249691,200800,48891,51191,299818,1300,187,6496,7769,257256
2010_2,944453,655575,2059,273925,209417,64508,50898,314187,1300,228,5818,7160,288878
2010_3,1010837,693629,1854,284060,215392,68668,66544,327916,1300,221,4235,7499,317208
2010_4,1021864,698322,2108,288071,208536,79535,72842,321924,1300,224,4821,7032,323542
2011_1,1018972,702589,2299,295182,203992,91190,68782,323617,1254,214,4169,7072,316383
2011_2,1088183,749762,2397,320187,207857,112330,79552,334615,1254,239,4187,7331,338421
2011_3,1186185,814454,2384,339017,222364,116653,94462,364443,1254,381,4909,7604,371731
2011_4,1280414,873231,2306,392763,283234,109529,72536,390554,1254,434,5251,8133,407183
2012_1,1275407,875479,2546,431967,328582,103385,46326,379539,1254,988,4858,8001,399928
2012_2,1322844,916044,2774,465540,360809,104731,37200,394743,496,462,6818,8011,406800
2012_3,1357046,938014,2512,490535,396016,94519,34453,393480,496,503,7837,8198,419032
2012_4,1392454,954346,2440,490264,398853,91411,39353,403942,496,385,8905,8561,438108
2013_1,1428596,974042,2671,501632,405121,96511,27581,423997,496,254,8041,9370,454554
2013_2,1395007,960042,2594,488631,388433,100198,44035,406693,496,1425,7415,8753,434965
2013_3,1407109,992399,2574,492922,383066,109856,60405,417609,496,1710,7274,9409,414710
2013_4,1422551,989825,2213,497773,376868,120905,53086,417580,496,1659,7044,9974,432726
2014_1,1442733,1013497,2352,500619,380470,120149,71176,421088,496,1308,6822,9636,429236
2014_2,1483111,1049167,2357,505652,381766,123886,99381,423516,496,1242,6646,9877,433944
2014_3,1531531,1092851,2198,508206,384282,123924,121975,441704,496,1368,6798,10106,438680
2014_4,1663058,1241160,2269,552494,413089,139405,205222,462102,496,1126,7039,10412,421898
2015_1,1686275,1246196,2342,542815,417661,125154,205902,476782,496,644,7074,10141,440079
2015_2,1656322,1223651,2064,531409,401530,129879,202628,469350,496,1004,6994,9706,432671
2015_3,1689291,1241697,2139,548147,408788,139359,192833,481287,496,592,6786,9417,447594
2015_4,1678112,1210210,1696,540558,403853,136705,179453,472123,496,545,6390,8949,467902
2016_1,1748963,1267771,1821,560108,418832,141276,196979,491780,496,600,6422,9565,481192
2016_2,1908123,1384370,1857,583134,437933,145201,238963,543425,496,524,6171,9800,523753
2016_3,1967792,1425292,1910,611511,459338,152173,211848,582723,496,499,5863,10442,542500
2016_4,1934565,1391308,1805,625768,475087,150681,175036,571409,496,432,6111,10251,543257
2017_1,1965682,1427021,1915,636643,490350,146293,184895,585182,496,511,6706,10673,538661
2017_2,1957813,1416857,1928,631862,482126,149736,178611,586172,496,458,6996,10334,540956
2017_3,1927734,1386970,1908,620717,477547,143170,153569,592649,496,272,7156,10203,540764
2017_4,1976494,1418895,1963,617145,482780,134365,170477,611021,496,582,7673,9538,557599
2018_1,1966243,1412677,2893,611675,471782,139893,164055,615419,496,230,8107,9802,553566
2018_2,1981670,1429549,2944,621048,479250,141798,174607,611991,496,221,8296,9946,552121
2018_3,1933045,1391701,2876,602051,469811,132240,161039,607550,496,323,8103,9263,541344
2018_4,1982658,1413980,2742,596875,476362,120513,177855,618720,496,235,7864,9193,568678
2019_1,2037707,1463532,2680,603007,476592,126415,192277,647582,496,155,7822,9513,574175
2019_2,2093734,1495518,2675,614457,491938,122519,198621,661472,496,341,7692,9764,598216
2019_3,2198506,1564080,1076,629865,511891,117974,229506,685235,496,332,7224,10346,634426
2019_4,2095125,1455816,1173,611177,494974,116203,140908,683909,496,316,7522,10315,639309